Abilene Christian	WAC
Air Force	MWC
Akron	MAC
Alabama	SEC
Alabama A&M	SWAC
Alabama St.	SWAC
Albany	AE
Alcorn St.	SWAC
American	PL
Appalachian St.	SB
Arizona	B12
Arizona St.	B12
Arkansas	SEC
Arkansas Pine Bluff	SWAC
Arkansas St.	SB
Army	PL
Auburn	SEC
Austin Peay	ASun
BYU	B12
Ball St.	MAC
Baylor	B12
Bellarmine	ASun
Belmont	MVC
Bethune Cookman	SWAC
Binghamton	AE
Boise St.	MWC
Boston College	ACC
Boston University	PL
Bowling Green	MAC
Bradley	MVC
Brown	Ivy
Bryant	AE
Bucknell	PL
Buffalo	MAC
Butler	BE
CSUN	BW
Cal Baptist	WAC
Cal Poly	BW
Cal St. Bakersfield	BW
Cal St. Fullerton	BW
California	ACC
Campbell	CAA
Canisius	MAAC
Central Arkansas	ASun
Central Connecticut	NEC
Central Michigan	MAC
Charleston	CAA
Charleston Southern	BSth
Charlotte	Amer
Chattanooga	SC
Chicago St.	NEC
Cincinnati	B12
Clemson	ACC
Cleveland St.	Horz
Coastal Carolina	SB
Colgate	PL
Colorado	B12
Colorado St.	MWC
Columbia	Ivy
Connecticut	BE
Coppin St.	MEAC
Cornell	Ivy
Creighton	BE
Dartmouth	Ivy
Davidson	A10
Dayton	A10
DePaul	BE
Delaware	CAA
Delaware St.	MEAC
Denver	Sum
Detroit Mercy	Horz
Drake	MVC
Drexel	CAA
Duke	ACC
Duquesne	A10
East Carolina	Amer
East Tennessee St.	SC
East Texas A&M	Slnd
Eastern Illinois	OVC
Eastern Kentucky	ASun
Eastern Michigan	MAC
Eastern Washington	BSky
Elon	CAA
Evansville	MVC
FIU	CUSA
Fairfield	MAAC
Fairleigh Dickinson	NEC
Florida	SEC
Florida A&M	SWAC
Florida Atlantic	Amer
Florida Gulf Coast	ASun
Florida St.	ACC
Fordham	A10
Fresno St.	MWC
Furman	SC
Gardner Webb	BSth
George Mason	A10
George Washington	A10
Georgetown	BE
Georgia	SEC
Georgia Southern	SB
Georgia St.	SB
Georgia Tech	ACC
Gonzaga	WCC
Grambling St.	SWAC
Grand Canyon	WAC
Green Bay	Horz
Hampton	CAA
Harvard	Ivy
Hawaii	BW
High Point	BSth
Hofstra	CAA
Holy Cross	PL
Houston	B12
Houston Christian	Slnd
Howard	MEAC
IU Indy	Horz
Idaho	BSky
Idaho St.	BSky
Illinois	B10
Illinois Chicago	MVC
Illinois St.	MVC
Incarnate Word	Slnd
Indiana	B10
Indiana St.	MVC
Iona	MAAC
Iowa	B10
Iowa St.	B12
Jackson St.	SWAC
Jacksonville	ASun
Jacksonville St.	CUSA
James Madison	SB
Kansas	B12
Kansas City	Sum
Kansas St.	B12
Kennesaw St.	CUSA
Kent St.	MAC
Kentucky	SEC
LIU	NEC
LSU	SEC
La Salle	A10
Lafayette	PL
Lamar	Slnd
Le Moyne	NEC
Lehigh	PL
Liberty	CUSA
Lindenwood	OVC
Lipscomb	ASun
Little Rock	OVC
Long Beach St.	BW
Longwood	BSth
Louisiana	SB
Louisiana Monroe	SB
Louisiana Tech	CUSA
Louisville	ACC
Loyola Chicago	A10
Loyola MD	PL
Loyola Marymount	WCC
Maine	AE
Manhattan	MAAC
Marist	MAAC
Marquette	BE
Marshall	SB
Maryland	B10
Maryland Eastern Shore	MEAC
Massachusetts	A10
McNeese	Slnd
Memphis	Amer
Mercer	SC
Mercyhurst	NEC
Merrimack	MAAC
Miami FL	ACC
Miami OH	MAC
Michigan	B10
Michigan St.	B10
Middle Tennessee	CUSA
Milwaukee	Horz
Minnesota	B10
Mississippi	SEC
Mississippi St.	SEC
Mississippi Valley St.	SWAC
Missouri	SEC
Missouri St.	MVC
Monmouth	CAA
Montana	BSky
Montana St.	BSky
Morehead St.	OVC
Morgan St.	MEAC
Mount St. Mary's	MAAC
Murray St.	MVC
N.C. State	ACC
NJIT	AE
Navy	PL
Nebraska	B10
Nebraska Omaha	Sum
Nevada	MWC
New Hampshire	AE
New Mexico	MWC
New Mexico St.	CUSA
New Orleans	Slnd
Niagara	MAAC
Nicholls	Slnd
Norfolk St.	MEAC
North Alabama	ASun
North Carolina	ACC
North Carolina A&T	CAA
North Carolina Central	MEAC
North Dakota	Sum
North Dakota St.	Sum
North Florida	ASun
North Texas	Amer
Northeastern	CAA
Northern Arizona	BSky
Northern Colorado	BSky
Northern Illinois	MAC
Northern Iowa	MVC
Northern Kentucky	Horz
Northwestern	B10
Northwestern St.	Slnd
Notre Dame	ACC
Oakland	Horz
Ohio	MAC
Ohio St.	B10
Oklahoma	SEC
Oklahoma St.	B12
Old Dominion	SB
Oral Roberts	Sum
Oregon	B10
Oregon St.	WCC
Pacific	WCC
Penn	Ivy
Penn St.	B10
Pepperdine	WCC
Pittsburgh	ACC
Portland	WCC
Portland St.	BSky
Prairie View A&M	SWAC
Presbyterian	BSth
Princeton	Ivy
Providence	BE
Purdue	B10
Purdue Fort Wayne	Horz
Queens	ASun
Quinnipiac	MAAC
Radford	BSth
Rhode Island	A10
Rice	Amer
Richmond	A10
Rider	MAAC
Robert Morris	Horz
Rutgers	B10
SIUE	OVC
SMU	ACC
Sacramento St.	BSky
Sacred Heart	MAAC
Saint Francis	NEC
Saint Joseph's	A10
Saint Louis	A10
Saint Mary's	WCC
Saint Peter's	MAAC
Sam Houston St.	CUSA
Samford	SC
San Diego	WCC
San Diego St.	MWC
San Francisco	WCC
San Jose St.	MWC
Santa Clara	WCC
Seattle	WAC
Seton Hall	BE
Siena	MAAC
South Alabama	SB
South Carolina	SEC
South Carolina St.	MEAC
South Dakota	Sum
South Dakota St.	Sum
South Florida	Amer
Southeast Missouri	OVC
Southeastern Louisiana	Slnd
Southern	SWAC
Southern Illinois	MVC
Southern Indiana	OVC
Southern Miss	SB
Southern Utah	WAC
St. Bonaventure	A10
St. John's	BE
St. Thomas	Sum
Stanford	ACC
Stephen F. Austin	Slnd
Stetson	ASun
Stonehill	NEC
Stony Brook	CAA
Syracuse	ACC
TCU	B12
Tarleton St.	WAC
Temple	Amer
Tennessee	SEC
Tennessee Martin	OVC
Tennessee St.	OVC
Tennessee Tech	OVC
Texas	SEC
Texas A&M	SEC
Texas A&M Corpus Chris	Slnd
Texas Southern	SWAC
Texas St.	SB
Texas Tech	B12
The Citadel	SC
Toledo	MAC
Towson	CAA
Troy	SB
Tulane	Amer
Tulsa	Amer
UAB	Amer
UC Davis	BW
UC Irvine	BW
UC Riverside	BW
UC San Diego	BW
UC Santa Barbara	BW
UCF	B12
UCLA	B10
UMBC	AE
UMass Lowell	AE
UNC Asheville	BSth
UNC Greensboro	SC
UNC Wilmington	CAA
UNLV	MWC
USC	B10
USC Upstate	BSth
UT Arlington	WAC
UT Rio Grande Valley	Slnd
UTEP	CUSA
UTSA	Amer
Utah	B12
Utah St.	MWC
Utah Tech	WAC
Utah Valley	WAC
VCU	A10
VMI	SC
Valparaiso	MVC
Vanderbilt	SEC
Vermont	AE
Villanova	BE
Virginia	ACC
Virginia Tech	ACC
Wagner	NEC
Wake Forest	ACC
Washington	B10
Washington St.	WCC
Weber St.	BSky
West Georgia	ASun
West Virginia	B12
Western Carolina	SC
Western Illinois	OVC
Western Kentucky	CUSA
Western Michigan	MAC
Wichita St.	Amer
William & Mary	CAA
Winthrop	BSth
Wisconsin	B10
Wofford	SC
Wright St.	Horz
Wyoming	MWC
Xavier	BE
Yale	Ivy
Youngstown St.	Horz
